baseInfo{
    name='Grandma (Destruction)'
    baseVolume='0.5'
    defaultTimeAlive='600'
}

defaultTheme{
    playerWedge='211d14ff'
    playerCircle='f7f6edff'
    background='b5b49eff'
    textColor='211d14ff'
    noteColor='211d14ff'
    frameColor='f7f6edff'
}

bullets{
    [1867, 1, 0, -1, -1]
    [2100, 1, 0, -1, -1]
    [3083, 1, 2, -1, -1]
    [3250, 1, 2, -1, -1]
    [5067, 1, 0, -1, -1]
    [5250, 1, 0, -1, -1]
    [6317, 1, 6, -1, -1]
    [6500, 1, 6, -1, -1]
    [8350, 1, 2, -1, -1]
    [8533, 1, 2, -1, -1]
    [9567, 1, 6, -1, -1]
    [9717, 1, 6, -1, -1]
    [11567, 1, 4, -1, -1]
    [11750, 1, 4, -1, -1]
    [12783, 1, 0, -1, -1]
    [12950, 1, 0, -1, -1]
    [14883, 1, 0, -1, -1]
    [15167, 1, 2, -1, -1]
    [15667, 1, 6, -1, -1]
    [16067, 1, 4, -1, -1]
    [16500, 1, 4, -1, -1]
    [16850, 1, 6, -1, -1]
    [17283, 1, 2, -1, -1]
    [17633, 1, 0, -1, -1]
    [18067, 1, 0, -1, -1]
    [18500, 1, 2, -1, -1]
    [18917, 1, 6, -1, -1]
    [19317, 1, 4, -1, -1]
    [19683, 1, 4, -1, -1]
    [20067, 1, 6, -1, -1]
    [20500, 1, 2, -1, -1]
    [20917, 1, 0, -1, -1]
    [21317, 1, 0, -1, -1]
    [21683, 1, 2, -1, -1]
    [22067, 1, 6, -1, -1]
    [22533, 1, 0, -1, -1]
    [22917, 1, 0, -1, -1]
    [23317, 1, 6, -1, -1]
    [23750, 1, 6, -1, -1]
    [24117, 1, 4, -1, -1]
    [24533, 1, 4, -1, -1]
    [24933, 1, 2, -1, -1]
    [25317, 1, 2, -1, -1]
    [25683, 1, 0, -1, -1]
    [26117, 1, 6, -1, -1]
    [26517, 1, 4, -1, -1]
    [26917, 1, 2, -1, -1]
    [27333, 1, 0, -1, -1]
    [27767, 2, 0, 1700, -1]
    [27767, 1, 0, -1, -1]
    [29767, 1, 6, -1, -1]
    [30200, 1, 0, -1, -1]
    [30567, 1, 2, -1, -1]
    [31000, 1, 0, -1, -1]
    [31400, 1, 6, -1, -1]
    [31850, 1, 4, -1, -1]
    [32217, 1, 2, -1, -1]
    [32633, 2, 0, 900, -1]
    [32633, 1, 0, -1, -1]
    [33783, 1, 6, -1, -1]
    [34267, 2, 2, 1600, -1]
    [34267, 1, 2, -1, -1]
    [36283, 1, 2, -1, -1]
    [36700, 1, 0, -1, -1]
    [37117, 1, 6, -1, -1]
    [37517, 2, 4, 700, -1]
    [37517, 1, 4, -1, -1]
    [38317, 2, 2, 1700, -1]
    [38317, 1, 2, -1, -1]
    [40376, 1, 4, -1, -1]
    [40783, 2, 0, 1700, -1]
    [40783, 1, 0, -1, -1]
    [42817, 1, 6, -1, -1]
    [43217, 1, 2, -1, -1]
    [43617, 1, 6, -1, -1]
    [44000, 1, 2, -1, -1]
    [44417, 1, 0, -1, -1]
    [44800, 1, 6, -1, -1]
    [45217, 1, 4, -1, -1]
    [45583, 2, 2, 800, -1]
    [45583, 1, 2, -1, -1]
    [46800, 1, 6, -1, -1]
    [47200, 1, 0, -1, -1]
    [49200, 1, 2, -1, -1]
    [49633, 1, 0, -1, -1]
    [50067, 1, 6, -1, -1]
    [50500, 2, 0, 500, -1]
    [50500, 1, 0, -1, -1]
    [51217, 2, 2, 2000, -1]
    [51217, 1, 2, -1, -1]
    [53700, 2, 0, 650, -1]
    [53700, 1, 0, -1, -1]
    [54550, 2, 2, 500, -1]
    [54550, 1, 2, -1, -1]
    [55250, 2, 4, 500, -1]
    [55250, 1, 4, -1, -1]
    [55967, 1, 6, -1, -1]
    [56167, 2, 0, 400, -1]
    [56167, 1, 0, -1, -1]
    [56733, 1, 2, -1, -1]
    [56950, 2, 0, 650, -1]
    [56950, 1, 0, -1, -1]
    [57800, 2, 4, 550, -1]
    [57800, 1, 4, -1, -1]
    [58550, 2, 6, 400, -1]
    [58550, 1, 6, -1, -1]
    [59183, 1, 6, -1, -1]
    [59400, 2, 0, 350, -1]
    [59400, 1, 0, -1, -1]
    [59950, 1, 2, -1, -1]
    [60167, 2, 0, 600, -1]
    [60167, 1, 0, -1, -1]
    [61017, 2, 2, 550, -1]
    [61017, 1, 2, -1, -1]
    [61767, 2, 4, 450, -1]
    [61767, 1, 4, -1, -1]
    [62450, 1, 6, -1, -1]
    [62600, 1, 0, -1, -1]
    [63033, 1, 2, -1, -1]
    [63467, 2, 4, 2800, -1]
    [63467, 1, 4, -1, -1]
    [66650, 1, 0, -1, -1]
}


